44 44 44 44 44 44 44 44 44 44 44 44 44 44 44 44 44 44 44 44 44 44 44 44 44 44 44 44 44 44 44 44
44 43 43 43 44 44 43 43 43 43 43 43 44 44 43 43 43 43 43 43 44 44 43 43 43 43 43 43 44 44 43 44
44 43 43 43 44 44 43 43 43 43 43 43 44 44 43 43 43 43 43 43 44 44 43 43 43 43 43 43 44 44 43 44
44 43 43 43 43 43 43 43 43 43 43 43 43 43 43 43 43 43 43 43 43 43 43 43 43 43 43 43 43 43 43 44
44 43 43 43 43 43 43 43 43 43 43 43 43 43 43 43 43 43 43 43 43 43 43 43 43 43 43 43 43 43 43 44
44 43 43 43 43 43 44 44 43 43 43 43 43 43 44 44 43 43 43 43 43 43 44 44 43 43 43 43 43 43 43 44
44 43 43 43 43 43 44 44 43 43 43 43 43 43 44 44 43 43 43 43 43 43 44 44 43 43 43 43 43 43 43 44
44 43 43 43 43 43 43 43 43 43 43 43 43 43 43 43 43 43 43 43 43 43 43 43 43 43 43 43 43 44 44 44
44 43 43 43 43 43 43 43 43 43 43 43 43 43 43 43 43 43 43 43 43 43 43 43 43 43 43 43 43 44 44 44
44 44 44 43 43 43 43 43 44 44 43 43 43 43 43 43 44 44 43 43 43 43 43 43 44 44 43 43 43 43 43 44
44 44 44 43 43 43 43 43 44 44 43 43 43 43 43 43 44 44 43 43 43 43 43 43 44 44 43 43 43 43 43 44
44 43 43 43 43 43 43 43 43 43 43 43 43 43 43 43 43 43 43 43 43 43 43 43 43 43 43 43 43 43 43 44
44 43 43 43 43 43 43 43 43 43 43 43 43 43 43 43 43 43 43 43 43 43 43 43 43 43 43 43 43 43 43 44
44 44 44 43 43 43 43 43 43 44 44 43 43 43 43 43 43 44 44 43 43 43 43 43 43 44 44 43 43 43 43 44
44 44 44 43 43 43 43 43 43 44 44 43 43 43 43 43 43 44 44 43 43 43 43 43 43 44 44 43 43 43 43 44
44 43 43 43 43 43 43 43 43 43 43 43 43 43 43 43 43 43 43 43 43 43 43 43 43 43 43 43 43 43 43 44
44 43 43 43 43 43 43 43 43 43 43 43 43 43 43 43 43 43 43 43 43 43 43 43 43 43 43 43 43 43 43 44
44 43 43 44 44 43 43 43 43 43 43 44 44 43 43 43 43 43 43 44 44 43 43 43 43 43 43 44 44 43 43 44
44 43 43 44 44 43 43 43 43 43 43 44 44 43 43 43 43 43 43 44 44 43 43 43 43 43 43 44 44 43 43 44
44 43 43 43 43 43 43 43 43 43 43 43 43 43 43 43 43 43 43 43 43 43 43 43 43 43 43 43 43 43 43 44
44 43 43 43 43 43 43 43 43 43 43 43 43 43 43 43 43 43 43 43 43 43 43 43 43 43 43 43 43 43 43 44
44 43 43 43 43 44 44 43 43 43 43 43 43 44 44 43 43 43 43 43 43 44 44 43 43 43 43 43 43 44 44 44
44 43 43 43 43 44 44 43 43 43 43 43 43 44 44 43 43 43 43 43 43 44 44 43 43 43 43 43 43 44 44 44
44 43 43 43 43 43 43 43 43 43 43 43 43 43 43 43 43 43 43 43 43 43 43 43 43 43 43 43 43 43 43 44
44 43 43 43 43 43 43 43 43 43 43 43 43 43 43 43 43 43 43 43 43 43 43 43 43 43 43 43 43 43 43 44
44 44 44 43 43 43 43 44 44 43 43 43 43 43 43 44 44 43 43 43 43 43 43 44 44 43 43 43 43 44 44 44
44 44 44 43 43 43 43 44 44 43 43 43 43 43 43 44 44 43 43 43 43 43 43 44 44 43 43 43 43 44 44 44
44 43 43 43 43 43 43 43 43 43 43 43 43 43 43 43 43 43 43 43 43 43 43 43 43 43 43 43 43 43 43 44
44 43 43 43 43 43 43 43 43 43 43 43 43 43 43 43 43 43 43 43 43 43 43 43 43 43 43 43 43 43 43 44
44 44 44 43 43 43 43 43 43 44 44 43 43 43 43 43 43 44 44 43 43 43 43 43 43 44 44 43 43 44 44 44
44 44 44 43 43 43 43 43 43 44 44 43 43 43 43 43 43 44 44 43 43 43 43 43 43 44 44 43 43 44 44 44
44 44 44 44 44 44 44 44 44 44 44 44 44 44 44 44 44 44 44 44 44 44 44 44 44 44 44 44 44 44 44 44